-----------------------------
!                      -    /
                       -     
-                      -    -
-                      -    -
--                     -    -
---                    -    -
- --                   -    -
-  --                  -    -
-   --                 -    -
-    ----              -    -
-       ---            -    -
-         ---          -    -
-    *      -----      -    -
-                      -    -
-                      -    -
-                           -
-             -             -
-            --             -
-                           -
-      --              -   *-
-----------------------------