-----------------------------
-           #        -##  % -
-  P        #        --#    -
-           #        --#    -
-           #       ---#    -
!           #          #    -
            #          #    -
-           #          #    -
-     *     #          #    -
-           #         ---   -
-           #         ---   -
-           #               -
-           #               -
-           -               -
-                           -
-               *           -
-                           -
-                           -
-           --              -
-           #--             /
-         * #---             
-----------------------------