-----------------------------
!    P              --      -
  H         ----       -    -
-     *                  -  -
-                    ---    -
-                           -
----                        -
-                           /
-                            
-                           -
-                           -
-                --         -
-                           -
-                           -
- -                         -
-                           -
-                           -
-            -            ---
-                    -      -
-                    -      -
-                    -   &  -
-----------------------------